1111111111
1C000000E1
1011100111
1V10V10001
1100001101
100000C001
1010011111
10000000P1
1111111111
