11111111111111111111
11111111111111111111
11111111111111111111
11111111CPE111111111
11111111111111111111
11111111111111111111
11111V11111111111111
11111111111111111111
