111111111111111111111111111111111111111111111111111
1111111111111000CCCCC0000000000000000000000000000E1
111000000000000000000000000000000000000001111111111
11010000000000C000000000000000000000000000000000001
111111111111111111111111111111111111110111111111111
11111111111100000000CCCC000000000000000000000000001
1111111111111111111111010000010C0000100000000000111
111111111111111111111111111111111111111111101111111
111111111111111111111111111111111111111111101111111
11111111P000000000000000V00000C00000000000000000001
111111111111111111111111111111111111111111111111111
