111111111111111111111111111111111111111111111111111
1111111111111000000000000000000000000000000000000E1
111000000000000000000000000000000000000001111111111
11010000000000C000000000000000000000000000000000001
111111111111111111111111111111111111110111111111111
111111111111000000000000000000000000000000000000001
1111111111111111111111010000010C0000100000000000111
111111111111111111111111111111111111111111101111111
111111111111111111111111111111111111111111101111111
111111111000000000000000000000C00000000000000000001
111111111111111111111101111111111111111111111111111
111111111111111111111101111111111111111111111111111
1111111111111111111111C1111111111111111111111111111
111111111111111111111101111111111111111111111111111
111111111111111111111101111111111111111111111111111
111111111111111111111101111111111111111111111111111
111111111111111111111101111111111111111111111111111
1111111111111111111111P1111111111111111111111111111
111111111111111111111111111111111111111111111111111
